000000000000000000000000000000000000000000000000000
011101111111111111110111111111111101110111111111110
000101000000000100010000010000000100010101000000010
010101011111011101110111110111110101110101010111110
010101000101010001000100000100010101000101010100000
011101111101011101111101111111010101111101010101110
010000000000010100000000000001000101000001010100010
010111111111010111011111111111011101011101010111010
010100000001000001010100010000010001000101010001010
011101111101111111010101110111110111111101011111110
000001000100000000010101000100000000000101000000010
011101110111111101110101010101110111011101111101010
010100010001000001000101010101010101000000000101010
010111011101011111010101110101010101110111110101110
010000000101010000010100010101010100010100010100000
011111111101011101110101110101011101010111011101110
010000000001000101010100010101000001010001000001010
011101111101110101010111010111011111011101111111010
010001000100010100010001000000010000000100000000010
010111010111110111111101111111111111110101111111110
000100010000010000000100000000000000010101000000010
011101110111110111011101111111110111011101111101110
010000010100000001010000000100010001000001000101000
010111110111011111010111110111011101111111010101110
010101000001010100010001010001000100010000010100000
010101111101010111011111010111011111011111010111110
010001010001010001000000010100000001000001010000010
011101011111011101110111110101111101111101011101110
010101000000000001010100000101000100000101000101000
010101110111111111010101011101010111010101111101110
010100010000010100000101010101010001010100000000010
010111011111110101110101110111011101011111111101110
010001000000000101010100000001010101000000000101000
011101110111010101011101111101110101110111110101110
000100010101010101000001000100000100010100010100010
011101011101011101011101010111011101010101110111110
010001000001010001010101010001010001010101000000010
011111110111010101110111011111010111010101011111110
000001000100010100000000010000010001010101010000000
010111011101110111111111011111011111010101111101110
010100010000010100000100000001000001010000000100010
011101011111010101111101111101110111011111011111110
010001000001010100000001000100010100000001000000010
011111111101011101110111110101110101111101111101110
000100000001000101010100000101000101000101000100000
011101111111011101011101111101110101010101110111110
010001000100000001000001000000010001010100000000010
010101011101111101011101111111010111010111110111110
010101000001000101010100000100010100010000010100010
011101111111110111110111110111111101111111111101110
000000000000000000000000000000000000000000000000000
